# list/query fields
academicYear=学年
semester=学期
theClassName=班级名称
classLeavesName=班别名称
tuition=学费
classH=上课总时数
creator=建档人员
createDate=建档日期
reviser=修档人员
reviseDate=修档日期

# E
Canvas01=基本资料
classInfoSn2=班级名称
classLeavesSn2=班别名称
tuition=学费
classH=课总时数

Canvas02=带班老师
cTitles=职称别
empNo=员编

Canvas03=学生资料
cName=姓名(中)
eName=姓名(英)
gender=性别
stuNo=学号
birthDate=生日

# message
message01=幼儿基本资料

# Q
classInfoSn=班级
classLeavesSn=班别